00000000000000000000
00000000000000000000
11110000000000100000
10010000000000100000
10010000000100100000
11110111011111111100
10010101000100100100
10010111000100100100
10010100000100100100
11110111000100100100
00000000000000000000
00000000000000000000
00000000000000000000
