00000000000000000000
00000000000000000000
00000000011110000000
00000000110011111100
00001111110011000110
00011111111101000010
00111101110110000010
00111111111111111110
00101111111010000011
00110111011100000011
00000001100000000011
00000000000000000011
00000000000000000000
