00000000000000000000
00000000000000000000
00000000000000000000
00011110111110000000
00010000000010000000
00010000000010000000
00010000000010000000
00010000000010000000
00010000000010000000
00010000000010000000
00011111111110000000
00000000000000000000
00000000000000000000
