00000000000000000000
00000000000000000000
00000011111111111110
00001111000001111000
00111100000000001100
01101000000000000100
01001000000000000010
01011000000000000010
01110000110000000010
00000111000000000110
00011000000000001100
00001111111111110000
00000000000000000000
