00000000000000000000
00000000000000000000
00000000000000000000
00000000011100000000
00000011110110000000
00000110000011000000
00011000000001000000
00010000000000000000
00010000000000000000
00010000000000000000
00011000000000000000
00000000000000000000
00000000000000000000
