00000000000000000000
00000000000000000000
00000000000000000000
00000000000111000000
00000000111101110000
00000001000000010000
00000010000000011000
00000010000000001000
00000010000000001100
00000011100000000100
00000000000000000000
00000000000000000000
00000000000000000000
