00000000000000000000
00000000000000000000
00000000001111100000
00000000111000011000
00001111111100001100
00111011111111101100
00100011011000101000
00100011010000110000
00110011001111100000
00011011000011000000
00001111101110000000
00000000010000000000
00000000000000000000
