00000000000000000000
00000000000000000000
00000000000000000000
00000000000000000011
00000000111111110001
00000011000000001100
00001100000000000110
00011000000000000001
00010000000000000000
00011001111000000000
00001111000000000000
00000000000000000000
00000000000000000000
