00000000000000000000
00000000000000000000
00000000000000000000
00000000000011000000
00000000111101110000
00000011000000011000
00001100000000001000
00001000000000011000
00001100000000111000
00000110000000101000
00000001100001101000
00000000000000111000
00000000000000000000
