00000000000000000000
00000000000000000000
00000000000000000000
00001111111111100000
00000000000000100000
00000000000000100000
00000000000000100000
00000000000000100000
00001110000000100000
00000011111111100000
00000000000000000000
00000000000000000000
00000000000000000000
