00000000000000000000
00000000000000000000
00000111111000000000
00001100000111000000
00001000000001100000
00001000000000110000
00001000000000010000
00001000000000010000
00001100000000110000
00000111111111100000
00000000000000000000
00000000000000000000
00000000000000000000
