00000000000000000000
00000000000000000000
01000010001000000000
01000010000000000000
01000010001000000000
01000010001000000000
01111110001000000000
01000010001000000000
01000010001000000000
01000010001000000000
01000010001000000000
00000000000000000000
00000000000000000000
