00000000000000000000
00000000000000000000
00000000000000000000
00000000000011110000
00000010000010010000
00000110000010011000
00000100000010001000
00000100000010001000
00000010000110011000
00000001111000110000
00000000000111100000
00000000000100000000
00000000000000000000
