00000000000100000000
00000000001100000000
00000000111000000000
00000001100000000000
00000011000000000000
00000110000000000000
00000100000000000000
00001000000000000000
00000000000000000000
00010000000000000000
00010000000000000000
00010000000000000000
00110000000000000000
