00000000000000000000
00000000000001111110
00000000000000010010
00001111111111111110
00011000000000000100
00010000000000000100
00100000000000000100
00100000000000001100
00100000000110111000
00110011111000000000
00011100000000000000
00000000000000000000
00000000000000000000
