00000000000000000000
00000000000000000000
00000000000000000000
00000000000000000000
00000111111111111110
01111100000000000000
01000000000000000000
01100000000000000000
00110000010000000000
00011111100000000000
00000000000000000000
00000000000000000000
00000000000000000000
