00000000000000000000
00000000000000000000
00000000000011100000
00000000001100000000
00000000110000000000
00000000100000000000
00000000100000000000
00000000100000000000
00000000111011000000
00000000001110000000
00000000000000000000
00000000000000000000
00000000000000000000
