00000000000000000000
00000000000000000000
00000000000100110000
00000000000100111100
00000000000100100011
00000000000100000001
00000000000100000000
00000000000010000001
00000000000011100011
00000000000000011110
00000000000000000000
00000000000000000000
00000000000000000000
